dummy_crate	dummy_crate
tokio-rustls	tokio-rustls
hyper-util	hyper-util
futures	futures-vendored
im	im-rs
ssh2	ssh2-rs
sval	sval
unicode-bom	unicode-bom
openssl-src	openssl-src-rs
fxhash	fxhash
liblzma	liblzma-rs
ripgrep	ripgrep
humantime	humantime
xattr	xattr
rustc-hex	rustc-hex
parking_lot	parking_lot
terminal_size	terminal-size
expectrl	expectrl
defer	defer
wasi	wasi
colorify	colorify
ordered-multimap	ordered-multimap-rs
similar	similar
generator	generator-rs
leb128	leb128
rustc-stable-hash	rustc-stable-hash
tinyvec_macros	tinyvec_macros
async-io	async-io
async-std	async-std
thin-vec	thin-vec
cexpr	rust-cexpr
supports-hyperlinks	supports-hyperlinks
http-auth	http-auth
group	group
castaway	castaway
surf	surf
fallible-streaming-iterator	fallible-streaming-iterator
http	http
sccache	sccache
heapless	heapless
termtree	termtree
vec_mut_scan	vec_mut_scan
textwrap	textwrap
test-strategy	test-strategy
is-terminal	is-terminal
async-net	async-net
memoffset	memoffset
piper	piper
crossbeam	crossbeam
libtest-mimic	libtest-mimic
atoi	atoi
test	nix
miri	miri
native-tls	rust-native-tls
utf16_iter	utf16_iter
memchr	memchr
linux-raw-sys	linux-raw-sys
quote	quote
sync_wrapper	sync_wrapper
unicode-width	unicode-width
sysinfo	sysinfo
rustc-literal-escaper	rustc-literal-escaper
conpty	conpty
bumpalo	bumpalo
backtrace	backtrace-rs
tinyvec	tinyvec
yaml-rust2	yaml-rust2
zip	zip2
regex	regex
html-escape	html-escape
jiff	jiff
cap	cap
itertools	itertools
pathdiff	pathdiff
layout-cli	layout
utf8-width	utf8-width
kvm	kvm-sys-rs
hex	rust-hex
stability	stability
fsevent	fsevent-rust
rusty-fork	rusty-fork
env_logger	env_logger
instant	instant
typesize	typesize
assert-impl	assert-impl
no-panic	no-panic
float-cmp	float-cmp
log	log
displaydoc	displaydoc
patch-build-rs	patch-build-rs
ryu	ryu
const-random	constrandom
async-channel	async-channel
clang-sys	clang-sys
build-alert	build-alert
mime_guess	mime_guess
io-uring	io-uring
parking	parking
async-stream	async-stream-vendored
dashmap	dashmap
document-features	document-features
rustfmt-nightly	rustfmt
macrotest	macrotest
tracing-chrome	tracing-chrome
event-listener	event-listener
is-docker	is-docker
matchers	matchers
async-fs	async-fs
unicase	unicase
allocator-api2	allocator-api2
async-task	async-task
rustls-native-certs	rustls-native-certs
event-listener-strategy	event-listener-strategy
async-attributes	async-attributes
sized-chunks	sized-chunks
rustc_apfloat	rustc_apfloat
winapi-util	winapi-util
csv	rust-csv
crc-catalog	crc-catalog
pin-project	pin-project
errno	rust-errno
atty	atty
approx	approx
rowan	rowan
vte	vte
want	want
gloo	gloo
async-global-executor	async-global-executor
encoding_rs	encoding_rs
cmake	cmake-rs
bitflags	bitflags
serde_bytes	serde-rs-bytes
bytes	bytes
multer	multer-vendored
half	half-rs
shell-words	shell-words
jobserver	jobserver-rs
write16	write16
include-dir-macro	include-dir-macro-rs
unicode-segmentation	unicode-segmentation
zerocopy	zerocopy
rustc_version	rustc-version-rs
once_cell	once_cell
tinytemplate	TinyTemplate
ed25519-compact	rust-ed25519-compact
miow	miow
typed-arena	rust-typed-arena
jni	jni-rs
blink-alloc	blink-alloc
serde_stacker	serde-stacker
crypto-bigint	crypto-bigint
xshell	xshell
assert_matches	assert_matches
fallible-iterator	rust-fallible-iterator
chrono	chrono
equivalent	equivalent
httparse	httparse
ansiterm	ansiterm-rs
subtle	subtle
base64	rust-base64
supports-unicode	supports-unicode
schannel	schannel-rs
salsa	salsa
version_check	version_check
indoc	indoc
sharded-slab	sharded-slab
scopeguard	scopeguard
serde-value	serde-value
clap	clap
generic-array	generic-array
bstr	bstr
fnv	rust-fnv
filetime	filetime
jwalk	jwalk
strsim	strsim-rs
jni-sys	jni-sys
getrandom	getrandom
arraydeque	arraydeque
proc-macro2	proc-macro2
sdd	scalable-delayed-dealloc
once_cell_polyfill	once_cell_polyfill
dot	dot
dissimilar	dissimilar
hashlink	hashlink
typetag	typetag
orion	orion
android_system_properties	android_system_properties
clippy	rust-clippy
convert_case	convert-case
flate2	flate2-rs
is_executable	is_executable
trybuild	trybuild
portable-atomic	portable-atomic
handlebars	handlebars-rust
dyn-clone	dyn-clone
async-process	async-process
winapi	winapi-rs
xz2	xz2-rs
iai	iai
x86	rust-x86
ref-cast	ref-cast
crc	crc-rs
pin-project-lite	pin-project-lite
heck	heck
tracing-tree	tracing-tree
walkdir	walkdir
ctrlc	ctrlc
normpath	normpath
bit-vec	bit-vec
odds	odds
tar	tar-rs
md5	md5
static_assertions	static-assertions-rs
globwalk	globwalk
language-server-mcp	language-server-mcp-rs
foldhash	foldhash
adler2	adler2
wasm_sync	wasm_sync
uluru	uluru
num-complex	num-complex
signal-hook	signal-hook
rust-ini	rust-ini
miniz_oxide_c_api	miniz_oxide
normalize-line-endings	normalize-line-endings
triomphe	triomphe
lazycell	lazycell
constant_time_eq	constant_time_eq
console	console
h2	h2
config	config-rs
pin-utils	pin-utils
pkg-config	pkg-config-rs
lzma-rust2	lzma-rust2
prettyplease	prettyplease
temp-env	temp-env
content_inspector	content_inspector
addr2line	addr2line
idna_adapter	idna_adapter
atomic-waker	atomic-waker
cesu8	cesu8-rs
coverage-helper	coverage-helper
itoa	itoa
is-wsl	is-wsl
num-conv	num-conv
libc	libc
pulldown-cmark-to-cmark	pulldown-cmark-to-cmark
target-triple	target-triple
paste	paste
untrusted	untrusted
serde_cbor	cbor
mio	mio
wait-timeout	wait-timeout
cfg_aliases	cfg_aliases
num-modular	num-modular
os_str_bytes	os_str_bytes
quick-error	quick-error
jni-sys	rust-jni-sys
ron	ron-rs
ahash	ahash
quick-xml	quick-xml
async-graphql	async-graphql
humansize	humansize
anyhow	anyhow
rustls-pki-types	pki-types
split-decls-genesis	split-decls-genesis
faster-hex	faster-hex
critical-section	critical-section
pasetors	pasetors
claude-code-mux	claude-code-mux
gimli	gimli
combine	combine
oorandom	oorandom
warp	warp
synstructure	synstructure
libcorn	corn
arrayref	arrayref
option_set	option_set
libnghttp2-sys	nghttp2-rs
cargo	cargo
loom	loom
slug	slug
redox_syscall	syscall
unicode-xid	unicode-xid
unicode-truncate	unicode-truncate
arc-swap	arc-swap
wasm-bindgen	wasm-bindgen
plist	rust-plist
dot-parser	dot-parser
slab	slab
futures-lite	futures-lite
uuid	uuid
cargo_metadata	cargo_metadata
async-lock	async-lock
expect-test	expect-test
crossterm_winapi	crossterm-winapi
hash32	hash32
simd-adler32	simd-adler32
quickcheck	quickcheck
scoped-tls	scoped-tls
prodash	prodash
rustc-demangle	rustc-demangle
imara-diff	imara-diff
litrs	litrs
tokio-stream	tokio-stream-vendored
twox-hash	twox-hash
json5	json5-rs
ufmt	ufmt
serde_test	test
iri-string	iri-string
serde-untagged	serde-untagged
gg-alloc	gg-alloc
tiny-keccak	tiny-keccak
hermit-kernel	kernel
httpdate	httpdate
ar_archive_writer	ar_archive_writer
crc32fast	rust-crc32fast
open	open-rs
same-file	same-file
unicode-normalization	unicode-normalization
ct-codecs	rust-ct-codecs
darling	darling
hf-dataset-validator	hugging-face-dataset-validator-rust
rustversion	rustversion
petgraph	petgraph
crunchy	crunchy
bincode	bincode
permutohedron	permutohedron
serde_ignored	serde-ignored
kstring	kstring
async-executor	async-executor
polling	polling
stable_deref_trait	stable_deref_trait
async-signal	async-signal
bitmaps	bitmaps
inventory	inventory
clru	clru-rs
reqwest	reqwest
rocksdb	rocksdb
num_threads	num_threads
cast	cast
blake3	BLAKE3
headers	headers
is_ci	is_ci
proc-macro-error2	proc-macro-error-2
rayon	rayon
async-trait	async-trait
hyper	hyper
concurrent-queue	concurrent-queue
lru-slab	lru-slab
openssl-probe	openssl-probe
diff	diff
cassowary	cassowary-rs
findshlibs	findshlibs
thiserror	thiserror
criterion	criterion.rs
mycelial-usage-data	mycelial-usage-data
arbitrary	arbitrary
vcpkg	vcpkg-rs
watch	inotify
futures-timer	futures-timer
mime	mime
r-efi	r-efi
smallvec	rust-smallvec
thread_local	thread_local-rs
fs_extra	fs_extra
winnow	winnow
hyper-tls	hyper-tls
encode_unicode	encode_unicode
value-bag	value-bag
sha1_smol	sha1-smol
serde_urlencoded	serde_urlencoded
object	object
smol	smol
rusqlite	rusqlite
num-order	num-order
tokio-test	tokio-test-vendored
shlex	rust-shlex
ident_case	ident_case
lazy_static	lazy-static
rustls-webpki	webpki
human_format	human-format-rs
autocfg	autocfg
bytesize	bytesize
ptyprocess	ptyprocess
termcolor	termcolor
ring	ring
arrayvec	arrayvec
fs-err	fs-err
hyper-rustls	hyper-rustls
criterion	criterion
dunce	dunce
web-time	web-time
typeid	typeid
cc	cc-rs
yansi	yansi
proc-macro-crate	proc-macro-crate
fixedbitset	fixedbitset
try-lock	try-lock
winreg	winreg-rs
dlv-list	dlv-list-rs
defmac	defmac
glob	glob
annotate-snippets	annotate-snippets-rs
rustix	rustix
blocking	blocking
aho-corasick	aho-corasick
nu-ansi-term	nu-ansi-term
fastrand	fastrand
mio-aio	mio-aio
byteorder	byteorder
ff	ff
split-decls-rs	split-decls-rs
is_terminal_polyfill	is_terminal_polyfill
libredox	libredox
maplit	maplit
text-size	text-size
ntapi	ntapi
hermit-kernel	libhermit-rs
minimal-lexical	minimal-lexical
rand	rand_chacha
maybe-async	maybe-async-rs
semver	semver
wasi	wasi-rs
git2	git2-rs
tera	tera
rustc-build-sysroot	rustc-build-sysroot
tokio-core	tokio-core
rand	rand
web-thread	wasm-worker
siphasher	siphasher
iana-time-zone	iana-time-zone
cfg-if	cfg-if
num-traits	num-traits
futures-concurrency	futures-concurrency
syn	syn
bit-set	bit-set
ucd-generate	ucd-generate
split-decls-clean	split-decls-clean
wit-bindgen-cli	wit-bindgen
cpp_demangle	cpp_demangle
shell-escape	shell-escape
crossterm	crossterm
rand	rand_core
nom	nom
kv-log-macro	kv-log-macro
erased-serde	erased-serde
ron	ron
unicode-ident	unicode-ident
lru	lru-rs
libz-sys	libz-sys
escargot	escargot
deunicode	deunicode
stacker	stacker
indexmap	indexmap
memmap2	memmap2-rs
rustc-hash	rustc-hash
gitoxide	gitoxide
curl	curl-rust
utf8_iter	utf8_iter
libloading	rust_libloading
atomic-maybe-uninit	atomic-maybe-uninit
camino	camino
itertools-num	itertools-num
unarray	unarray
automod	automod
either	either
nohash-hasher	nohash-hasher
tempfile	tempfile
scc	scalable-concurrent-containers
hashbrown	hashbrown
typenum	typenum
ipnet	ipnet
serde_json	json
rand_distr	rand_distr
